111111111111111111111111111111111
100000000000000000000000000000001
100000000000000000000000000000001
100000000000000000000000000000001
100000000000000000000000000000001
100000000000000000000000000000001
101111N01111110000000000000000111
100000000000000000000000000000001
10N000000000000000000000000000001
100000000000000000000000000000001
10000000000000P000000000000000001
100000000000000000000000000000001
10000000000000000000000000N000001
100000000000000000000000000000001
100000000000000000000000000000001
100000000000000000000000000000001
100000000000000000000000000000001
1N0000000000000000000000000000001
100000000000000000000000000000001
1000000E000000C000000000000000001
100000000000000000000000000000111
111111111111111111111111111111111