11111111111111111
10000000000000C01
10111111100111111
11111011101111111
10111111C01111111
11111111101111111
1011111110C111111
10000000000E00001
10000000000P00111
11111111111111111