11111
10CP1
11111
10001
11001
1E001
11111 