1111111111111111111111
1C000C0000C000C00000P1
1111111011111111111111
1C0000000000000000E001
1111110000111111111111
100C000C0000C00000C001
1111111111111111111111