1111111111111111111111
1010001011101110101111
1010101111111111111011
100P00000000000C001111
1C11101010111010111011
1111111011101010C01C11
1000111011111010111011
1010101011111110101011
111011101N001010011C11
1N000000000000000000E1
1111111111111111111111