1111111111111111111111
1010C01011101110101111
1010101111111111111011
10C0000P0000000C001111
1011101011111010111C11
1111111011101010C01011
10C0111011111011100011
1010101011111110101011
1110111010001C10111C11
1000C00C101010000000E1
1111111111111111111111