1111111111
1C0C0N0001
1110P00111
100C000E01
1111111111